08001B70
08001B7C
08001B88
08001B94
08001BA0
08001BAC
08001BB8
08001BC4