000020D6
000020E2
000020EE
000020FA
00002106
00002112
0000211E
0000212A