0800206C
08002078
08002084
08002090
0800209C
080020A8
080020B4
080020C0