00000DA2
00000DAE
00000DBA
00000DC6
00000DD2
00000DDE
00000DEA
00000DF6