000014AE
000014BA
000014C6
000014D2
000014DE
000014EA
000014F6
00001502