08001D36
08001D42
08001D4E
08001D5A
08001D66
08001D72
08001D7E
08001D8A