08001FCA
08001FD6
08001FE2
08001FEE
08001FFA
08002006
08002012
0800201E