000020B6
000020C2
000020CE
000020DA
000020E6
000020F2
000020FE
0000210A