0000140A
00001416
00001422
0000142E
0000143A
00001446
00001452
0000145E