00001402
0000140E
0000141A
00001426
00001432
0000143E
0000144A
00001456